道具を用いる	を	道具を
行動を代わる	に を	人間に 知的行動を
能力をする	で を	コンピュータ上で 知的能力を
判断をする	を	推論・判断を
データをする	を	画像データを
パターンをする	て を	解析して パターンを
処理を用いる	を	記号処理を
記述をする	と を	主体と 記述を
カウンセラーをする	を	カウンセラーを
役割をせる	に を	計算機に 役割を
注目を集める	が を	「サポートベクターマシン」が 注目を
学習を行う	に を を	元に 経験を 学習を
知性をする	に を	機械的に 知性を
流行を超える	を	流行を
ディープラーニングをする	にかけて を	2017年にかけて、 ディープラーニングを
学習を繰り返す	を	学習を
ことをいる	と を	基本と ことを
これらをする	を	これらを
システムを作る	を	知的システムを
学習をする	て で に は を を を通して	なされている。 ACT-Rでは、 元に ACT-Rでは、 推論ルールを、 統計的学習を 生成規則を通して
知能を上回る	で を	領域で 人工知能を
精度をおる	で は を	第3次人工知能ブームでは、 第3次人工知能ブームでは、 精度を
成果をいる	が で を	ディープラーニングが 分野で 成果を
進化をいる	て て において は を	活躍している。 加えて、 生成技術において （敵対的生成ネットワーク）は、 進化を
生成をいく	を	コンテンツ生成を
機をする	は を	ブレーズ・パスカルは 機械式計算機を
開発を行う	は を	エイダ・ラブレスは 開発を
革命をもたらす	に は を	形式論理に アルフレッド・ノース・ホワイトヘッドは 革命を
論文をする	に は を	1943年に ウォルター・ピッツは 論文を
基礎を築く	を	基礎を
用語を作り出す	で は を	会議で ジョン・マッカーシーは 用語を
言語をする	は を	彼はまた プログラミング言語を
テストをする	を	テストを
療法を行う	を	来談者中心療法を
パワーを示す	で に は を	プログラム中で 間に、 ジョエル・モーゼスは パワーを
限界を示す	て は を	出版して シーモア・パパートは 限界を
言語をする	は を	アラン・カルメラウアーは プログラミング言語を
システムをする	は を	テッド・ショートリッフェは ルールベースシステムを
パワーを示す	を	パワーを
コースをする	に を	自律的に コースを
乗り物をする	は を	ハンス・モラベックは、 乗り物を
成果を上げる	が で に は を	アプリケーションが 分野で 使われるようになった。 1990年代は 成果を
ギャモンをする	に は を	1992年に IBMは バックギャモン専用コンピュータ・TDギャモンを
ガルリ・カスパロフを負かす	に を	5月に ガルリ・カスパロフを
ユニットをする	において を	湾岸戦争において ユニットを
AIを使う	のに を	スケジューリングするのに AIを
全額を上回る	が を	コストが 投資全額を
ことをする	は を	国防高等研究計画局は、 ことを
付けをする	から に対して を	ここから 非構造化データに対して、 意味付けを
処理をせる	を	処理を
処理をせる	に に により を	同年に、 Webに ティム・バーナーズ＝リーにより、 知的処理を
意味をする	に を	データに 意味を
処理をせる	て に を	付加して、 コンピュータに 知的処理を
方法をする	に を	国際的に 方法を
オントロジーをする	を	オントロジーを
在り方をせる	を	在り方を
システムをする	と を	専門と エキスパートシステムを
円を費やす	として を	国家プロジェクトとして 570億円を
研究を進める	て を	費やして 研究を
命令をする	で を	機構で 命令を
問題をする	を	問題を
ルールを用いる	を	ルールを
特徴をする	を	特徴を
ブームを迎える	が に を	手法が 中心に ブームを
種類を増やす	て で に も を	合わせて、 白物家電製品でも 大幅に 白物家電製品でも 種類を
運転をする	に を	元に 運転を
特許をいる	が に まで を	日本が 2018年までに 2018年までに 特許を
さを活かす	に を	制御に 曖昧さを
研究をする	を	研究を
運転をする	て に を	基づいて、 柔軟に 運転を
注目を集める	から は を	ことから、 ファジィは 注目を
チューニングをする	を	チューニングを
制御をする	を	ニューロファジィ制御を
限界をする	を	限界を
ブームを巻き起こす	だけ て に は を	評価されるだけでなく、 成功して その後に、 松下電器は ブームを
成功を受ける	を	成功を
制御を用いる	て も を	受けて、 他社も 知的制御を
製品をする	を	製品を
対象をする	で に を	数式で 客観的に 対象を
機構を持つ	が を	対象が 機構を
工数を抑える	を	開発工数を
性をできる	ながら を	抑えながら、 柔軟性を
制御をする	から を	少なさから、 制御を
限界を迎える	で を	程度で 限界を
制御をする	を	知的制御を
人間をする	が で を	人工知能が 点で 人間を
進歩を担う	を	進歩を
世界をする	を	世界を
説をする	で を	著作で、 説を
データを扱う	を	データを
改善を果たす	が で に を	チームが 画像処理コンテストで 2012年に 精度改善を
プログラムを使う	を	専用プログラムを
問題をする	を	問題を
研究をいる	が て を	ジェフ・ホーキンスが、 向けて 研究を
理論をいる	が て で を	続けているが、 続けているが、 中で 理論を
システムをいる	て は は を	登場している。 これは ものではなく、 行動型システムを
性を導き出す	を	関連性を
ものを導き出す	を	ものを
能力を持つ	を	認識能力を
)をする	に は を	8月には、 8月には、 記号接地問題(シンボルグラウンディング問題)を
大差を付ける	で に を	画像処理コンテストで 手法に 圧倒的大差を
注目を集める	に を	急速に 注目を
現実味を持つ	を	現実味を
普及を受ける	を	普及を
脳をする	を	脳を
学習を組み合わせる	を	機械学習を
タスクを扱う	を	タスクを
モデルを動かす	で を	仮想空間で モデルを
ことをせる	に を	高速に ことを
成果をいる	も を	ことも 成果を
知をする	を	身体知を
振る舞いを見せる	を	振る舞いを
関心をおる	が に を	企業が 活用に 関心を
投資を行う	で に を	民間企業主導で 全世界的に 投資を
問題をできる	に を	リアルタイムに 組み合わせ最適化問題を
動向を受ける	を	動向を
遅れをする	が が に対して を	イーロン・マスクが、 人間が 人工知能に対して 遅れを
脳をする	に を	機械に 脳を
ブレイン・マシン・インターフェースをする	を	ブレイン・マシン・インターフェースを
社をいる	に を	ために、 ニューラ・リンク社を
ことをする	を	ことを
AIをする	を	AIを
心をする	が を	OpenAIが 好奇心を
探索を行う	で を	無報酬で 探索を
段階を経る	を	段階を
推論をする	て を	経て 推論を
アーキテクチャをする	は を	MITリンカーン研究所は アーキテクチャを
人間を上回る	で を	読解テストで 人間を
データをする	を	データを
ソフトウェアをいる	は を	Googleは ソフトウェアを
研究をおる	とも は を	マックスプランク研究所とも Googleは、 共同研究を
回路をする	から を	電子顕微鏡写真から 神経回路を
研究をいる	て を	始めており、 研究を
AIを位置づける	から で に は を	第13次5カ年計画から 中国では 国家プロジェクトに 中国では AIを
開発をてる	て で を	行っている。 官民一体で 研究開発を
児を集める	を	天才児を
実験をする	を	実験を
開発をいる	で を	日本で 研究開発を
性をいる	て を	されている。 可能性を
米国を超える	を	米国を
上位をいる	が て で も を	中国勢が なっている。 大会でも 大会でも 上位を
覇権をある	が で を	中国が AIで 覇権を
研究所を開く	に を	パリに AI研究所を
投資をする	に は まで を	2022年までに 韓国は、 2022年までに 投資を
機関をする	を	AI機関を
学習をする	を	深層学習を
シミュレーションを行う	を	脳シミュレーションを
人間を超える	を	人間を
反乱を起こす	て に対して を	於いて、 人間に対して 反乱を
性をいる	は を	『人工知能は 可能性を
警鐘をいる	を	警鐘を
弾圧を併せ持つ	を	弾圧を
知能をいる	が で を	中国が 政治目的で 人工知能を
警鐘をおる	て に は を	呼ばれているは ことに 呼ばれているは 警鐘を
人権をする	で を	人工知能で 人権を
体制を呼ぶ	て と と など は は を	鳴らしており、 重要となる。 「AI独裁」と メディアなどは 松尾豊は、 メディアなどは 政治体制を
感情をする	から で を	センサーから 人工知能で 感情を
監視をせる	に まで を	人工知能に 歩行者まで 監視を
情報をする	で を	人種プロファイリングで 個人情報を
手続きを経る	を を	ウイグル族を 法的手続きを
犯罪を犯す	で に も を	6月時点で 経ずに 約1万5千人も 犯罪を
AIを使う	を	AIを
人間を送る	が に を	コンピュータが 強制収容所に 人間を
化を恐れる	を	監視社会化を
カメラをする	を	監視カメラを
技術をおる	に は を	世界各国に 中国は AI監視技術を
データをする	で を	人工知能で ビッグデータを
適性を決める	て を	活用して 適性を
格差をする	を	格差を
差別を認める	を	差別を
研究をする	を	研究を
化をいる	は を	軍隊は、 自動化を
ミサイルをできる	て により は を	試みている。 ガトリング砲により アメリカ海軍は 対艦ミサイルを
標的をする	を	標的を
RCWSをせる	を	サムソンRCWSを
人間をいる	て に は を	稼働させて 境界線には 境界線には 人間を
能力を生む	は を	AIは 軍事能力を
展開を変える	を	展開を
戦争をせる	を	戦争を
バランスを決める	を	軍事バランスを
制御をおる	は を	AIプログラムは ファジィ制御を
判断を介す	から を	観点から 判断を
令を出す	に を	2012年に 開発禁止令を
これをする	に に は は を	2017年には ものに アメリカ合衆国国防総省は、 2017年には これを
器を操る	を	銃火器を
禁止をいる	が に は を	ヒューマン・ライツ・ウォッチが、 4月には 4月には 禁止を
運用をめぐる	を	運用を
ルールをする	を	国際ルールを
競争をいる	は を をめぐって	米国・中国・ロシアは 開発競争を 軍事利用をめぐって
記録をする	を	記録を
都市をする	を	都市を
艇を使う	を	自律無人艇を
試験を行う	を	試験を
感を与える	に は を	政界に 軍用AI開発は 危機感を
Googleをする	て と を	協力していると 協力していると Googleを
知能を用いる	を	人工知能を
追及を受ける	て で で と とともに は を	暴露されており、 公聴会では、 整合性で 拒否すると 「」とともに、 公聴会では、 追及を
研究をする	が を	Microsoftが 共同研究を
波紋を呼ぶ	に も を	同様に 際も 波紋を
国家をいる	が によって を	中国が AIによって 監視国家を
機をせる	で に を	中東で 大量に 無人攻撃機を
警鐘を鳴らす	に に は を	11月に ことに マーク・エスパー国防長官は 警鐘を
個人をする	を	個人を
世論を操る	たり により を	なりすましたり、 ボット投稿により 世論を
プロジェクトをする	で を	倫理面で 人工知能プロジェクトを
会をする	を	AI倫理委員会を
等をする	を	反科学・反マイノリティ・地球温暖化懐疑論等を
解任をする	て は を	含まれており、 Google社員らは 解任を
解散をする	が で を	倫理委員会が 理由で、 解散を
哲学をせる	に を	AIに 東洋哲学を
プロジェクトを挙げる	は を	井口尊仁は プロジェクトを
存在を見いだす	に を	ものに 霊的存在を
悟りをやる	を	悟りを
AIをする	と を	神と AIを
)」をいる	を	道)」を
実現をする	を	実現を
社会をする	を を通して	社会を 崇拝を通して
情報をする	が を	レバンドウスキーが 機密情報を
ことを訴える	を	ことを
裁判をいる	を	裁判を
世界をする	ずつ は を	ひとつずつ、 我々は 世界を
振る舞いをいる	は を	レバンドウスキーは 振る舞いを
話をいる	は を	哲学者は 話を
科学を語る	を	『科学を
ことをいる	が に は を	（科学哲学）が、 実際には 実際には ことを
問題をくる	を	問題を
成果をくる	も を	何も 成果を
者をいる	て と は を	語ろうとしてきた。 語ろうとしてきた。 理論物理学者ディラックは、 哲学者を
ウィトゲンシュタインを含める	を	ウィトゲンシュタインを
言語を使う	を	日常的言語を
疎通を行う	を	意思疎通を
脳を超える	における を	議論における 脳を
脳を捉える	として を	「デジタル情報処理システム」として 脳を
状況をする	で を	デジタルで 状況を
勘違いをする	を	勘違いを
科学を語る	を	『科学を
問題をなる	で と は を	定理ではない。 よると、 定理ではない。 問題を
要素を含む	を	要素を
問題を扱う	に を	哲学的・統一的に 「大きな」問題を
問題をなる	で は を	天文学では 天文学では 〔哲学的〕問題を
問題を扱う	し で も を	扱わなくなりましたし、 物理学でも 物理学でも 問題を
言葉を取り上げる	を	言葉を
言葉をする	に を	具体的に 言葉を
興味をいる	が を	「哲学者が 興味を
議論をくる	まで を	「これまで 議論を
